8 8
111111111
100010001
101000101
101010101
100010001
101010101
100000001
111111111